2,1,1,1,1,1,1,1,1,1,1,1,1,1,1,1,1,1,1,1,1,1,1,1,1,1,1,1,2,1,1,1,1,1,1,1,1,1,1,1,1,1,1,1,1,1,1,1,1,1,1,1,1,1,1,1
2,1,1,1,1,2,2,2,2,2,1,1,1,1,1,1,1,1,1,1,1,1,1,1,1,1,1,1,2,2,1,1,1,1,1,1,1,1,1,1,1,1,1,1,1,1,1,1,1,1,1,1,1,1,1,1
1,1,1,2,2,2,2,2,2,2,2,2,2,1,1,1,1,1,1,1,1,1,1,1,1,1,1,1,1,2,2,2,2,2,1,1,1,1,1,1,1,1,1,1,1,1,1,1,1,1,1,1,1,1,1,1
1,1,1,2,2,2,1,2,2,2,2,2,2,2,2,2,1,1,1,1,1,1,1,1,1,1,1,1,1,2,2,2,2,2,1,1,1,1,1,1,1,1,1,1,1,1,1,1,1,1,1,1,1,1,1,1
1,1,2,2,2,2,1,1,1,1,1,1,1,2,2,2,2,2,2,1,1,1,1,1,1,1,1,1,1,2,2,2,2,2,1,1,1,1,1,1,1,1,1,1,1,1,1,1,1,1,1,1,1,1,1,1
1,2,2,2,2,1,1,1,1,1,1,1,1,1,1,2,2,2,2,1,1,1,1,1,1,1,1,1,1,2,2,2,2,2,1,1,1,1,1,1,1,1,1,1,1,1,1,1,1,1,1,1,1,1,1,1
2,2,1,1,1,1,1,1,1,1,1,1,1,1,1,1,1,2,2,1,1,1,1,1,1,1,1,1,1,2,2,2,2,2,1,1,1,1,1,1,1,1,1,1,1,1,1,1,1,1,1,1,1,1,1,1
2,1,1,1,1,1,1,1,1,1,1,1,1,1,1,1,1,1,2,1,1,1,1,1,1,1,1,1,1,2,1,1,1,1,1,1,1,1,1,1,1,1,1,1,1,1,1,1,1,1,1,1,1,1,1,1
2,1,1,1,1,1,1,2,2,2,2,16,16,16,16,16,16,16,2,2,2,2,2,2,2,2,1,1,2,2,2,2,2,2,2,2,2,2,2,2,2,2,2,2,2,2,2,2,2,2,2,2,1,1,1,1
2,1,1,1,1,1,1,1,1,1,1,16,16,16,16,16,16,16,1,2,1,1,1,1,1,1,1,1,1,2,1,1,1,1,1,1,1,1,1,1,1,1,1,1,1,1,1,1,1,1,1,2,1,1,1,1
4,1,3,1,3,3,1,3,1,3,3,16,16,16,16,16,16,16,2,2,3,3,1,1,3,3,1,1,1,2,3,3,1,1,1,1,3,3,1,1,3,3,1,1,1,1,3,3,1,1,1,2,1,1,1,1
4,1,3,1,3,3,1,3,1,3,3,16,16,16,16,16,16,16,2,1,3,3,3,3,3,3,1,1,2,3,1,1,3,3,1,1,1,1,3,3,1,1,1,1,3,3,3,3,3,3,1,2,1,1,1,1
1,3,3,3,3,3,3,1,3,3,1,16,16,16,16,16,16,16,2,1,3,3,3,3,3,3,1,1,1,2,3,3,3,3,1,1,3,3,1,1,3,3,1,1,1,1,3,3,3,3,1,2,1,1,1,1
1,3,3,3,3,3,3,1,3,3,1,16,16,16,16,16,16,16,2,1,3,3,1,1,3,3,1,1,2,3,3,3,3,3,1,1,3,10,10,10,10,10,8,8,10,10,3,3,1,3,1,2,1,1,1,1
3,1,3,1,3,3,1,3,1,3,3,16,16,16,16,16,16,16,2,1,1,1,3,3,1,1,1,1,2,3,3,3,3,3,1,1,3,10,10,10,8,8,8,8,10,10,1,1,3,3,1,2,1,1,1,1
3,1,3,1,3,3,1,3,1,3,3,3,3,1,3,3,2,3,1,1,3,3,1,1,3,3,1,1,1,2,3,3,1,1,1,1,3,10,8,8,10,10,8,8,8,8,3,3,1,1,1,2,1,1,1,1
1,1,1,1,1,1,1,1,3,3,3,3,1,3,3,3,3,2,1,1,1,1,3,3,1,1,1,1,2,3,1,1,3,3,1,1,1,8,10,10,8,8,8,8,10,10,1,1,3,3,1,2,1,1,1,1
1,1,1,1,1,1,1,1,3,3,3,3,1,3,1,3,4,2,1,1,3,3,3,3,3,3,1,1,2,3,3,3,3,3,1,1,3,10,8,8,10,10,8,8,8,8,3,3,3,3,1,2,1,1,1,1
1,1,1,1,1,1,1,1,1,3,3,3,3,1,3,2,3,3,1,1,3,3,3,3,3,3,1,1,2,3,3,3,3,3,1,1,1,10,10,10,10,10,8,8,10,10,3,3,3,3,1,2,1,1,1,1
1,1,1,1,1,1,1,1,1,3,3,3,3,1,2,2,3,3,1,1,2,1,3,3,3,3,1,1,2,3,3,3,3,3,1,1,3,10,10,10,10,10,8,8,10,10,1,1,3,3,1,2,1,1,1,1
1,1,1,1,1,1,1,1,3,3,3,3,1,2,2,3,3,1,1,1,3,3,1,1,3,3,1,1,1,1,3,3,1,1,1,1,3,10,10,10,10,10,8,8,10,10,3,3,1,1,1,2,1,1,1,1
1,1,1,1,1,1,1,1,3,3,3,3,1,3,2,3,3,1,1,1,1,1,3,3,1,1,1,1,3,3,2,1,3,3,1,1,1,1,3,3,1,1,1,1,3,3,1,1,3,3,1,2,1,1,1,1
1,1,1,1,1,1,1,1,1,1,1,1,2,2,1,1,1,1,1,1,3,3,1,1,3,3,1,1,1,1,3,3,1,1,1,1,3,3,1,1,3,3,1,1,1,1,3,3,1,1,1,2,1,1,1,1
1,1,1,1,1,1,1,1,1,1,1,1,2,1,1,1,1,1,1,1,3,3,3,3,1,1,1,1,2,3,2,1,3,3,1,1,1,1,3,3,1,1,1,1,3,3,3,3,3,3,1,2,1,1,1,1
1,1,1,1,1,1,1,1,1,3,3,1,3,1,3,3,1,3,1,1,3,3,3,3,3,3,1,1,3,3,3,3,3,3,1,1,3,3,3,3,3,3,1,1,3,3,3,3,3,3,1,2,1,1,1,1
1,1,1,1,1,1,1,1,1,3,3,2,3,1,3,3,1,3,1,1,3,3,1,1,3,3,2,2,3,3,3,3,3,3,1,1,3,3,3,3,3,3,1,1,3,3,3,3,3,3,1,2,1,1,1,1
1,1,1,1,1,1,1,1,3,3,3,3,1,3,3,3,3,1,1,1,1,1,3,3,3,3,2,1,3,3,3,3,3,3,1,1,3,3,3,3,1,1,1,1,3,3,1,1,3,3,1,2,1,1,1,1
1,1,1,1,1,1,1,1,3,3,2,3,1,3,3,3,3,1,1,1,3,3,1,2,3,3,1,1,1,1,3,3,1,1,1,1,3,3,3,3,3,3,1,1,1,1,3,3,1,1,1,1,1,1,1,1
1,1,1,1,1,1,1,1,1,3,3,3,3,1,3,1,3,3,1,1,1,1,2,3,1,1,1,2,3,3,1,1,3,3,1,1,1,1,3,3,1,1,1,1,3,3,1,1,3,3,1,1,1,1,1,1
1,1,1,1,1,1,1,2,2,3,3,3,3,1,3,1,3,3,1,1,3,3,2,2,3,3,1,1,1,1,3,3,1,1,1,1,3,3,1,1,3,3,1,1,1,1,3,3,1,1,1,2,1,1,1,1
1,1,1,1,1,1,1,2,3,3,3,3,1,3,1,3,3,1,1,1,3,3,3,3,1,1,1,1,3,3,1,1,3,3,1,1,1,1,3,3,1,1,1,1,3,3,3,3,3,3,1,2,1,1,1,1
1,1,1,1,1,1,2,2,3,3,3,3,1,3,1,3,3,1,1,1,2,3,3,3,3,3,1,1,3,3,3,3,3,3,1,1,3,3,3,3,3,3,1,1,3,3,3,3,3,3,1,2,1,1,1,1
1,1,1,1,1,2,2,1,1,1,1,1,1,1,1,1,1,1,1,1,2,3,1,1,3,3,1,1,3,3,3,3,1,1,1,1,3,3,3,3,3,3,1,1,3,3,3,3,1,1,1,2,1,1,1,1
1,1,2,2,2,2,1,1,1,1,1,1,1,1,1,1,1,1,1,1,2,2,3,3,1,1,1,1,3,3,1,1,3,3,1,1,1,1,3,3,1,1,1,1,3,3,1,1,3,3,1,1,1,1,1,1
1,2,2,1,1,1,3,3,1,1,3,3,1,1,3,3,1,1,1,2,3,3,1,1,3,3,1,1,1,1,3,3,1,1,1,1,3,3,1,1,3,3,1,1,1,1,3,3,1,1,1,1,1,1,1,1
1,2,1,1,1,1,1,1,3,3,1,1,3,3,3,3,3,3,2,2,3,3,3,3,1,1,1,1,3,3,1,1,3,3,1,1,1,1,3,3,1,1,1,1,3,3,3,3,3,3,1,2,1,1,1,1
2,2,1,1,1,1,3,3,3,3,3,3,3,3,1,1,3,4,2,1,1,1,3,3,3,3,1,1,3,3,3,3,3,3,1,1,3,3,3,3,3,3,1,1,3,3,1,1,3,3,1,1,1,1,1,1
2,1,1,1,3,3,3,3,3,3,3,3,1,1,2,3,2,2,1,1,3,3,1,1,3,3,1,1,1,1,3,3,1,1,1,1,3,3,1,1,3,3,1,1,1,1,3,3,1,1,1,1,1,1,1,1
1,1,1,1,3,3,3,3,3,3,1,1,2,3,2,2,3,3,1,1,1,1,3,3,1,1,1,1,3,3,1,1,3,3,1,1,1,1,3,3,1,1,1,1,3,3,1,1,3,3,1,1,1,1,1,1
1,1,3,3,1,1,3,3,1,1,2,3,2,2,3,3,1,1,1,1,3,3,3,3,3,3,1,1,1,1,3,3,3,3,1,1,3,3,1,1,3,3,1,1,1,1,3,3,3,3,1,1,1,1,1,1
3,3,1,1,3,3,1,1,3,3,3,3,3,3,3,3,3,3,1,1,3,3,1,1,3,3,1,1,3,3,3,3,3,3,1,1,3,3,3,3,3,3,1,1,3,3,3,3,3,3,1,1,1,1,1,1
1,1,3,3,3,3,3,3,1,2,3,3,3,3,1,1,3,3,1,1,1,1,3,3,1,1,1,1,3,3,3,3,3,3,1,1,3,3,3,3,3,3,1,1,3,3,1,1,3,3,1,1,1,1,1,1
3,3,3,3,3,3,3,3,1,2,3,3,1,1,3,3,1,1,1,1,3,3,1,1,3,3,1,1,1,1,3,3,1,1,1,1,3,3,1,1,3,3,1,1,1,1,3,3,1,1,1,1,1,1,1,1
3,3,3,3,3,3,1,1,2,3,1,1,3,3,1,1,3,3,1,1,1,1,3,3,1,1,1,1,3,3,1,1,3,3,1,1,1,1,3,3,1,1,1,1,3,3,1,1,3,3,1,1,1,1,1,1
1,1,3,3,1,1,3,3,1,2,3,3,1,1,3,3,1,1,1,1,3,3,1,1,3,3,1,1,1,1,3,3,1,1,1,1,3,3,1,1,3,3,1,1,1,1,3,3,3,3,1,1,1,1,1,1
3,3,1,1,3,3,1,1,2,3,1,1,3,3,3,3,3,3,1,1,3,3,3,3,3,3,1,1,3,3,1,1,3,3,1,1,1,1,3,3,1,1,1,1,3,3,3,3,3,3,1,1,1,1,1,1
3,3,3,3,1,1,3,3,3,3,3,3,3,3,1,1,3,3,1,1,1,1,3,3,3,3,1,1,3,3,3,3,3,3,1,1,3,3,3,3,3,3,1,1,3,3,1,1,3,3,1,1,1,1,1,1
1,1,3,3,1,1,3,3,2,1,3,3,1,1,3,3,1,1,1,1,3,3,1,1,3,3,1,1,1,1,3,3,1,1,1,1,3,3,1,1,3,3,1,1,1,1,3,3,1,1,1,1,1,1,1,1
1,1,1,1,1,1,1,1,2,1,1,1,1,1,1,1,1,1,1,1,1,1,1,1,1,1,1,1,1,1,1,1,1,1,1,1,1,1,1,1,1,1,1,1,1,1,1,1,1,1,1,1,1,1,1,1
1,1,1,1,1,1,1,2,2,2,2,2,2,2,2,2,2,2,2,2,2,2,2,2,2,2,2,2,2,2,2,2,2,2,2,2,2,2,2,2,1,1,1,1,1,1,1,1,1,1,1,1,1,1,1,1
1,1,1,1,1,1,2,2,2,2,2,2,2,2,1,1,1,1,1,1,1,1,1,1,1,1,1,1,1,1,1,1,1,1,1,1,1,1,1,1,1,1,1,1,1,1,1,1,1,1,1,1,1,1,1,1
1,1,1,1,2,2,2,2,2,2,2,2,2,2,2,1,1,1,1,1,1,1,1,1,1,1,1,1,1,1,1,1,1,1,1,1,1,1,1,1,1,1,1,1,1,1,1,1,1,1,1,1,1,1,1,1
1,1,2,2,2,2,2,2,2,2,2,2,2,2,2,1,1,1,1,1,1,1,1,1,1,1,1,1,1,1,1,1,1,1,1,1,1,1,1,1,1,1,1,1,1,1,1,1,1,1,1,1,1,1,1,1
1,2,2,2,2,2,2,2,2,2,2,2,2,2,2,1,1,1,1,1,1,1,1,1,1,1,1,1,1,1,1,1,1,1,1,1,1,1,1,1,1,1,1,1,1,1,1,1,1,1,1,1,1,1,1,1
1,2,2,2,2,2,2,2,2,2,2,2,2,2,2,1,1,1,1,1,1,1,1,1,1,1,1,1,1,1,1,1,1,1,1,1,1,1,1,1,1,1,1,1,1,1,1,1,1,1,1,1,1,1,1,1
1,2,2,2,2,2,2,1,1,1,1,1,1,1,1,1,1,1,1,1,1,1,1,1,1,1,1,1,1,1,1,1,1,1,1,1,1,1,1,1,1,1,1,1,1,1,1,1,1,1,1,1,1,1,1,1
